S.##.....T
#T##..###.
#.###.###.
#.....###.
###T#####G
