SE##.....T
#T##..###.
#S###.###.
#G....###.
###T#####G
